SLI = "countries/Socialist Italy.txt"
RUS = "countries/Russia.txt"
KAR = "countries/Karelia.txt"
GOR = "countries/Gorki.txt"
KUB = "countries/Kuban.txt"
PEN = "countries/Penza.txt"
KAL = "countries/Kalmykia.txt"
KZN = "countries/Kazan.txt"
KBV = "countries/Kuibyshev.txt"
KMC = "countries/Kamchatka.txt"
CHK = "countries/Chukotka.txt"
VNE = "countries/Venezia.txt"
SKH = "countries/Sakhalin.txt"
VLD = "countries/Vladivostok.txt"
KHB = "countries/Khabarovsk.txt"
MGD = "countries/Magadan.txt"
AMU = "countries/Amur.txt"
ZBY = "countries/Zabaykalsky.txt"
BRY = "countries/Buryatia.txt"
KRS = "countries/Krasnoyarsk.txt"
IRK = "countries/Irkutsk.txt"
SAK = "countries/Sakha.txt"
KHK = "countries/Khakassia.txt"
BKN = "countries/Balkan.txt"
DAS = "countries/Dasoguz.txt"
PAV = "countries/Pavlodar.txt"
AKM = "countries/Akmola.txt"
KRG = "countries/Kurgan.txt"
BSH = "countries/Bashkortostan.txt"
PRM = "countries/Perm.txt"
CHE = "countries/Chelyabinsk.txt"
NVB = "countries/Novosibirsk.txt"
ENV = "countries/East Novosibirsk.txt"
TYU = "countries/Tyumen.txt"
KHM = "countries/Khanty-Mansi.txt"
YAN = "countries/Yamalo-Nenets.txt"
IZH = "countries/Izhevsk.txt"
WPM = "countries/West Perm.txt"
SYK = "countries/Syktyvkar.txt"
VOG = "countries/Vologda.txt"
KRU = "countries/Kurdistan - Syria.txt"
HEJ = "countries/Hejaz.txt"
ASI = "countries/Asir.txt"
NJD = "countries/Nejd.txt"
NYE = "countries/New York.txt"
NEE = "countries/New England.txt"
TEX = "countries/Texas.txt"
STX = "countries/South Texas.txt"
CAL = "countries/California.txt"
FLO = "countries/Florida.txt"
CAC = "countries/Cascadia.txt"
NEV = "countries/Nevada.txt"
MCH = "countries/Michigan.txt"
GRL = "countries/Great Lakes.txt"
MNE = "countries/Minnesota.txt"
KET = "countries/Kentucky.txt"
TEN = "countries/Tennessee.txt"
OKL = "countries/Oklahoma.txt"
ARK = "countries/Arkansas.txt"
PRA = "countries/Prairies.txt"
LOS = "countries/Lousiana.txt"
KNS = "countries/Kansas City.txt"
ALA = "countries/Alabama.txt"
MIS = "countries/Mississippi.txt"
WVR = "countries/West Virginia.txt"
PNN = "countries/Pennsylvania.txt"
CRD = "countries/Colorado.txt"
ARZ = "countries/Arizona.txt"
DES = "countries/Deseret.txt"
TXM = "countries/Texan New Mexico.txt"
NMX = "countries/New Mexico.txt"
DAK = "countries/Dakota.txt"
ENC = "countries/Enclave.txt"
CRW = "countries/Crow.txt"
WYO = "countries/Wyoming.txt"
VEG = "countries/Vegas.txt"
IDA = "countries/Idaho.txt"
DRD = "countries/Dravidia.txt"
KHA = "countries/Khalistan.txt"
LAD = "countries/Ladakh.txt"
AKS = "countries/Aksai Chin.txt"
EEL = "countries/Tamil Eelaam.txt"
SIN = "countries/Sindh.txt"
RJP = "countries/Rajputana.txt"
GOA = "countries/Goa.txt"
BHA = "countries/Bhartiya Federation.txt"
NAX = "countries/Naxalite India.txt"
ODI = "countries/Odisha.txt"
HYD = "countries/Hyderabad.txt"
AAA = "countries/Ancapistan.txt"
FSO = "countries/Federal Somalia.txt"
SSD = "countries/South Sudan.txt"
EAF = "countries/East African Federation.txt"
HAU = "countries/Hausa.txt"
MSR = "countries/Mandinka.txt"
BMB = "countries/Bambara.txt"
SON = "countries/Songhai.txt"
BIA = "countries/Biafra.txt"
FAW = "countries/Fulbe Adamawa.txt"
BYA = "countries/Baya.txt"
AZA = "countries/Azande.txt"
CKW = "countries/Chokwe.txt"
NM2 = "countries/Namibia2.txt"
TSW = "countries/Tswana.txt"
BOE = "countries/Boer.txt"
XHO = "countries/Xhosaland.txt"
ZUL = "countries/Zululand.txt"
LES = "countries/Lesotho.txt"
SWZ = "countries/Swaziland.txt"
TSO = "countries/Tsonga.txt"
RCA = "countries/RCanada.txt"
QUB = "countries/Quebec.txt"
BER = "countries/Bering.txt"
ALS = "countries/Alaska.txt"
YUK = "countries/Yukon.txt"
NEF = "countries/Newfoundland.txt"
USC = "countries/USCA.txt"
SPH = "countries/South Phillipines.txt"
LUZ = "countries/Luzon.txt"
BOR = "countries/Borneo.txt"
TOR = "countries/Torajan.txt"
MND = "countries/Mandar.txt"
LUW = "countries/Luwu.txt"
BUG = "countries/Bugis.txt"
MAK = "countries/Makassar.txt"
LFP = "countries/Free League.txt"
SAS = "countries/Sasak.txt"
MDU = "countries/Madura.txt"
SUN = "countries/Sunda.txt"
LMP = "countries/Lampung.txt"
PLM = "countries/Palembang.txt"
MNK = "countries/Minangkabau.txt"
ACH = "countries/Aceh.txt"
MTW = "countries/Mantawai.txt"
SCZ = "countries/Schizophrenia.txt"
JPF = "countries/People's Front.txt"
KOD = "countries/Kodoha.txt"
KYU = "countries/Kyushu.txt"
USN = "countries/USN.txt"
FED = "countries/JapFed.txt"
IWA = "countries/Iwate.txt"
MIY = "countries/Miyagi.txt"
YAM = "countries/Yamagata.txt"
NGT = "countries/Nigata.txt"
FUK = "countries/Fukushima.txt"
TOC = "countries/Tochigi.txt"
IBA = "countries/Ibaraki.txt"
CHB = "countries/Chiba.txt"
SHZ = "countries/Shizuoka.txt"
GUN = "countries/Gunma.txt"
NAO = "countries/Nagano.txt"
AIC = "countries/Aichi.txt"
MIE = "countries/Mie.txt"
TOK = "countries/Tokushima.txt"
EHI = "countries/Ehime.txt"
MIZ = "countries/Miyazaki.txt"
SHM = "countries/Shimane.txt"
HSH = "countries/Hiroshima.txt"
OKY = "countries/Okayama.txt"
MLR = "countries/Malay Republic.txt"
ALP = "countries/Alpes.txt"
BUR = "countries/Burgundy.txt"
NMD = "countries/Normandy.txt"
PIC = "countries/Picardie.txt"
POI = "countries/Poitou.txt"
PRS = "countries/Paris.txt"